#####################
# #   #       # #   #
# # ### ##### # # ###
# #   # # #         #
# # ### # ##### #####
#   #     # #   # # #
### ### ### # # # # #
#   # #     # #     #
# ### ### ##### #####
#     # #     #     #
##### # # ### #######
#     #     #   #   #
### ########### # # #
#   # #   #       # #
# ### ### # ####### #
#   #         #   # #
### ### ### ### # ###
#       #       #   #
# # # ####### # ### #
# # #   #     # #  G#
#####################
